MapChip.png
96 20
4 14 14 14 14 14 14 14 14 14 14 14 14 14 14 14 14 14 14 14 14 14 14 14 14 14 14 14 14 14 14 14 14 14 14 14 14 14 14 14 14 14 14 14 14 14 14 14 14 14 14 14 14 14 14 14 14 14 14 14 14 14 14 14 14 14 14 14 14 14 14 14 14 14 14 14 14 14 14 14 14 14 14 14 14 14 14 14 14 14 14 14 14 14 14  6
4  0  0  0  0  0  0  0  0  0  0  0  0  0  0  0  0  0  0  0  0  0  0  0  0  0  0  0  0  0  0  0  0  0  0  0  0  0  0  0  0 11 11  0  0  0  0  0  0 11 11  0  0  0  0  0  0  0  0  0  0  0  0  0  0 11  0  0  0  0  0  0  0  0  0  0  0  0  0  0  0  0  0  0  0  0  0  0  0  0  0  0  0  0  0  6
4  0  0  0  0  0  0  0  0  0  0  0  0  0  0  0  0  0  0  0  0  0  0  0  0  0  0  0  0  0  0  0  0  0  0  0  0  0  0  0  0 11 11  0  0  0  0  0  0 11 11  0  0  0  0  0  0  0  0  0  0  0  0  0  0 11  0  0  0  0  0  0  0  0  0  0  0  0  0  0  0  0  0  0  0  0  0  0  0  0  0  0  0  0  0  6
4  0  0  0  0  0  0  0  0  0  0  0  0  0  0  0  0  0  0  0  0  0  0  0  0  0  0  0  0  0  0  0  0  0  0  0  0  0  0  0  0 11 11  0  0  0  0  0  0 11 11  0  0  0  0  0  1  3  0  0  0  0  0  0  0 11  0  0  0  0  0  0  0  0  0  0  0  0  0  0  0  0  0  0  0  0  0  0  0  0  0  0  0  0  0  6
4  0  0  0  0  0  0  0  0  0  0  0  0  0  0  0  0  0  0  0  0  0  0  0  0  0  0  0  0  1  2  2  2  2  2  2  3  0  0  1  2  2  2  3  0  0  2  0  0 11 11  0  0  0  0  0  0  0  0  0  0  0  0  0  0 11  0  0  0  0  0  0  1  3  0  0  0  2  0  0  0  0  0  0  0  2  0  0  1  3  0  0  0  0  0  6
4  2  2  2  2  3  0  0  0  0  0  0  0  0  0  2  2  0  0  0  0  0  0  0  0  0  0  0  0  0  0  0  0  0  0  0  0  0  0  0  0  0  0  0  0  0  5  0  0 11 11  0  0  0  2  0  0  0  0  0  0  0  0  0  0 11  0  0  0  0  0  0  0  0  0  0  0  0  0  0  0  2  0  0  0  0  0  0 11  0  0  0  0  0  0  6
4  0  0  0  0  0  0  0  0  0  0  0  0  2  2  7  0  0  0  0  0  0  0  1  2  2  3  0  0  0  0  0  0  0  0  0  0  0  0  0  0  0  0  0  0  0  5  0  0 11 11  0  0  0  0  0  0  0  5  0  0  0  0  0  0 11  0  0  1  3  0  0  0  0  0  0  0  0  0  0  0  0  0  0  0  0  0  0 11  0  0  0  0  0  0  6
4  0  0  0  0  0  0  0  0  1  3  0  0  0  0  0  0  0  0  0  0  0  0  0  0  0  8  2  0  0  0  0  0  0  0  0  0  0  0  0  0  0  0  1  2  2  7  0  0 11 11  0  0  0  0  0  0  0  5  0  0  0  0  0  0 11  0  0  0  0  0  0  0  0  0  0  0  0  0  0  0  0  0  0  0  0  0  0 11  0  0  0  0  0  0  6
4  0  0  0  0  0  0  0  0  0  0  0  0  0  0  0  0  0  2  2  3  0  0  0  0  0  0  0  0  0  0  0  0  0  0  0  2  0  0  0  0  0  0  0  0  0 11  0  0  5  8  2  3  0  0  0  0  0  8  2  2  2  3  0  0 11  0  0  0  0  0  0  0  0  0  0  0  0  0  0  0  0  0  0  0  0  0  0 11  0  0  0  0  0  0  6
4  0  0  0  0  0  0  0  0  0  0  0  0  0  0  0  0  0  0  0  0  0  0  0  0  0  0  0  0  0  0  0  0  0  0  0  0  0  0  0  0  0  0  0  0  0 11  0  0  0  0  0  0  0  0  0  0  0  0  0  0  0  4  0  0 11  0  0  0  0  0  1  2  2  3  0  0  0  1  2  2  3  0  0  0  0  0  1 11  2  2  2  3  0  0  6
4  0  0  0  0  1  2  2  3  0  0  0  0  0  0  0  0  0  0  0  0  0  0  0  0  0  0  0  0  0  1  2  3  0  0  0  0  0  0  0  2  0  0  0  0  0 11  0  0  0  0  0  0  0  0  0  0  0  0  0  0  0  4  0  0 11  0  0  0  0  0  0  0  0  0  0  0  0  0  0  0  0  0  0  0  0  0  0 11  0  0  0  0  0  0  6
4  0  0  0  0  0  0  0  0  0  0  0  0  0  0  0  0  0  0  0  0  0  0  0  0  0  0  0  0  0  0  0  0  0  0  0  0  0  0  0  0  0  0  0  0  0 11  0  0  0  1  2  2  2  2  2  3  0  0  0  0  0  4  0  0 11  0  0  0  0  0  0  0  0  0  0  0  0  0  0  0  0  0  0  0  0  0  0 11  0  0  0  0  0  0  6
4  0  0  0  0  0  0  0  0  0  0  0  0  0  0  0  0  0  0  0  0  0  0  0  0  0  0  0  0  0  0  0  0  0  0  2  0  0  0  0  0  0  0  2  0  0 11  0  0  0  0  0  0  0  0  0  0  0  0  0  0  0  4  0  0 11  0  0  1  2  3  0  0  0  0  0  0  0  0  0  0  0  0  0  0  1  2  2 11  0  0  0  0  0  0  6
4  2  2  2  3  0  0  0  0  2  2  0  0  2  2  2  3  0  0  0  0  0  0  0  0  1  2  2  3  0  0  0  0  0  0  0  0  0  0  0  0  0  0  0  0  0 11  0  0  0  0  0  0  0  0  0  0  0  0  4  0  0  5  0  0 11  0  0  0  0  0  0  0  1  3  0  0  0  0  0  0  0  2  0  0  0  0  0 11  0  0  0  0  0  0  6
4  0  0  0  0  0  0  0  0  0  0  0  0  0  0  0  0  0  0  0  0  0  0  0  0  0  0  0  0  0  0  0  0  0  0  0  0  0  0  0  0  0  0  0  0  0 11  0  0  0  0  0  0  0  0  0  0  0  0  4  0  0  5  0  0 11  0  0  0  0  0  0  0  0  0  0  0  0  0  0  0  0  0  0  0  0  0  0 11  0  0  1  2  2  2  6
4  0  0  0  0  0  0  0  0  0  0  0  0  0  0  0  0  0  0  0  0  1  3  0  0  0  0  0  0  0  0  0  1  2  2  3  0  0  2  0  0  1  3  0  0  1 11  0  0  0  0  0  0  0  0  1  2  2  7  5  0  0  4  0  0  0  0  0  0  0  0  0  0  0  0  0  0  0  0  0  0  0  0  0  0  0  0  0 11  0  0  0  0  0  0  6
4  0  0  0  0  0  2  2  0  0  0  0  0  0  0  0  0  0  0  0  0  4  6  0  0  0  0  0  1  3  0  0  0  0  0  0  0  0  0  0  0  0  0  0  0  0 11  0  0  1  2  2  3  0  0  0  0  0  0  4  0  0  4  0  0  0  1  2  2  2  3  0  0  1  2  2  2  2  2  3  0  0  1  2  2  2  2  2 11  0  0  0  0  0  0  6
4  0  0  0  0  0  0  0  0  0  0  0  0  0  0  0  0  0  0  0  0  4  6  0  0  0  0  0  0  0  0  0  0  0  0  0  0  0  0  0  0  0  0  0  0  0 11  0  0  0  0  0  0  0  0  0  0  0  0  0  0  0  4  0  0  0  0  0  0  0  0  0  0  0  0  0  0  0  0  0  0  0  0  0  0  0  0  0 11  0  0  0  0 12  0  6
4  0  0  0  0  0  0  0  0  0  0  0  0  0  0  0  0  0  0  0  0  4  6  0  0  0  0  0  0  0  0  0  0  0  0  0  0  0  0  0  0  0  0  0  0  0 11  0  0  0  0  0  0  0  0  0  0  0  0  0  0  0  4  0  0  0  0  0  0  0  0  0  0  0  0  0  0  0  0  0  0  0  0  0  0  0  0  0 11  0  0  0  0 13  0  6
4 10 10 10 10 10 10 10 10 10 10  9  9  9  9  9  9  9  9  9  9  5  5  9  9  9  9  9 10 10 10  9  9  9  9  9  9  9  9 10  9 10 10 10  9  9 11  2  2  2  2  2  2  2  2  2  2  2  2  5  2  2  2  2  2  2  2  2  2  2  2  2  2  2  2  2  2  2  2  2  2  2  2  2  2  2  2  2 11  9  9  9  9  9  9  6